{
  "h": ["ሀ", "ሁ", "ሂ", "ሃ", "ሄ", "ህ", "ሆ", "ኋ"],
  "l": ["ለ", "ሉ", "ሊ", "ላ", "ሌ", "ል", "ሎ", "ሏ"],
  "H": ["ሐ", "ሑ", "ሒ", "ሓ", "ሔ", "ሕ", "ሖ", "ሗ"],
  "m": ["መ", "ሙ", "ሚ", "ማ", "ሜ", "ም", "ሞ", "ሟ"],
  "S2": ["ሠ", "ሡ", "ሢ", "ሣ", "ሤ", "ሥ", "ሦ", "ሧ"],
  "r": ["ረ", "ሩ", "ሪ", "ራ", "ሬ", "ር", "ሮ", "ሯ"],
  "s": ["ሰ", "ሱ", "ሲ", "ሳ", "ሴ", "ስ", "ሶ", "ሷ"],
  "S": ["ሸ", "ሹ", "ሺ", "ሻ", "ሼ", "ሽ", "ሾ", "ሿ"],
  "q": ["ቀ", "ቁ", "ቂ", "ቃ", "ቄ", "ቅ", "ቆ", "ቋ"],
  "b": ["በ", "ቡ", "ቢ", "ባ", "ቤ", "ብ", "ቦ", "ቧ"],
  "v": ["ቨ", "ቩ", "ቪ", "ቫ", "ቬ", "ቭ", "ቮ", "ቯ"],
  "t": ["ተ", "ቱ", "ቲ", "ታ", "ቴ", "ት", "ቶ", "ቷ"],
  "c": ["ቸ", "ቹ", "ቺ", "ቻ", "ቼ", "ች", "ቾ", "ቿ"],
  "n": ["ነ", "ኑ", "ኒ", "ና", "ኔ", "ን", "ኖ", "ኗ"],
  "G": ["ኘ", "ኙ", "ኚ", "ኛ", "ኜ", "ኝ", "ኞ", "ኟ"],
  "x": ["አ", "ኡ", "ኢ", "ኣ", "ኤ", "እ", "ኦ", "ኧ"],
  "k": ["ከ", "ኩ", "ኪ", "ካ", "ኬ", "ክ", "ኮ", "ኳ"],
  "w": ["ወ", "ዉ", "ዊ", "ዋ", "ዌ", "ው", "ዎ", ""],
  "z": ["ዘ", "ዙ", "ዚ", "ዛ", "ዜ", "ዝ", "ዞ", "ዟ"],
  "Z": ["ዠ", "ዡ", "ዢ", "ዣ", "ዤ", "ዥ", "ዦ", "ዧ"],
  "Y": ["የ", "ዩ", "ዪ", "ያ", "ዬ", "ይ", "ዮ", "ዯ"],
  "d": ["ደ", "ዱ", "ዲ", "ዳ", "ዴ", "ድ", "ዶ", "ዷ"],
  "j": ["ጀ", "ጁ", "ጂ", "ጃ", "ጄ", "ጅ", "ጆ", "ጇ"],
  "g": ["ገ", "ጉ", "ጊ", "ጋ", "ጌ", "ግ", "ጎ", "ጏ"],
  "T": ["ጠ", "ጡ", "ጢ", "ጣ", "ጤ", "ጥ", "ጦ", "ጧ"],
  "C": ["ጨ", "ጩ", "ጪ", "ጫ", "ጬ", "ጭ", "ጮ", "ጯ"],
  "P": ["ጰ", "ጱ", "ጲ", "ጳ", "ጴ", "ጵ", "ጶ", "ጷ"],
  "f": ["ፈ", "ፉ", "ፊ", "ፋ", "ፌ", "ፍ", "ፎ", "ፏ"],
  "p": ["ፐ", "ፑ", "ፒ", "ፓ", "ፔ", "ፕ", "ፖ", "ፗ"],
  "-": ["፡"], ",": ["፣"], ".": ["።"],
  ";": ["፤"], ":": ["፥"]
}
